Ngamnij	Arch-int
Chakchai	So-In
Somjit	Arch-int
Chaiyapon	Keeratikasikorn
Punyaphol	Horata
Sartra	Wongthanavasu
Sirapat	Chiewchanwattana
Khamron	Sunat
Chitsutha	Soomlek
Nagon	Watanakij
Boonsup	Waikham
Paweena	Wanchai
Pipat	Reungsang
Pusadee	Seresangtakul
Monlica	Wattana
Wararat	Songpan
Sunti	Tintanai
Saiyan	Saiyod
Silada	Intarasothonchun
Urachart	Kokaew
Urawan	Chanket
Phet	Aimtongkham
Wachirawut	Thamviset
Warunya	Wunnasri
Rapassit	Chinnapatjee
Sakpod	Tongleamnak
Thanaphon	Tangchoopong
Sarun	Apichontrakul
Rasamee	Suwanwerakamtorn
Chanon	Dechsupa
Praisan	Padungweang
Sumonta	Kasemvilas
watcharawatchara	sritionwong
watchara	sritonwong
adisorn	naruang
Pongsathon	Janyoi
Rojanawan	Hadi	
Tidarat 	Luangrungruang	
Pakarat	Musikawan
Yanika	Kongsorot